"filename", "language", "Python", "comment", "blank", "total"
"/home/data_sapiens/programs/projects/aslan/wardrobe/__init__.py", "Python", 0, 0, 1, 1
"/home/data_sapiens/programs/projects/aslan/wardrobe/data_utils/__init__.py", "Python", 0, 0, 1, 1
"/home/data_sapiens/programs/projects/aslan/wardrobe/data_utils/extract_similar.py", "Python", 70, 0, 25, 95
"/home/data_sapiens/programs/projects/aslan/wardrobe/data_utils/extract_unseen_distances.py", "Python", 42, 6, 25, 73
"/home/data_sapiens/programs/projects/aslan/wardrobe/data_utils/preprocessing.py", "Python", 186, 1, 63, 250
"/home/data_sapiens/programs/projects/aslan/wardrobe/data_utils/wandb_logging.py", "Python", 67, 0, 27, 94
"/home/data_sapiens/programs/projects/aslan/wardrobe/pipelines/berts/bert_on_synthetic_data.py", "Python", 150, 11, 56, 217
"/home/data_sapiens/programs/projects/aslan/wardrobe/pipelines/berts/clinc_bert.py", "Python", 74, 3, 23, 100
"/home/data_sapiens/programs/projects/aslan/wardrobe/pipelines/berts/few_shot_pretraining.py", "Python", 68, 1, 17, 86
"/home/data_sapiens/programs/projects/aslan/wardrobe/pipelines/berts/many_berts.py", "Python", 87, 3, 24, 114
"/home/data_sapiens/programs/projects/aslan/wardrobe/pipelines/gpt2/dummy_gpt2.py", "Python", 65, 5, 18, 88
"/home/data_sapiens/programs/projects/aslan/wardrobe/pipelines/gpt2/hard_negatives_gpt2.py", "Python", 114, 2, 33, 149
"/home/data_sapiens/programs/projects/aslan/wardrobe/pipelines/protonets/first_attempt.py", "Python", 87, 0, 31, 118
"/home/data_sapiens/programs/projects/aslan/wardrobe/pipelines/robertas/dnnc_replication.py", "Python", 139, 0, 35, 174
"/home/data_sapiens/programs/projects/aslan/wardrobe/pipelines/robertas/zero_shot_pretraining.py", "Python", 126, 0, 26, 152
"Total", "-", 1275, 32, 405, 1712